GRASS,GRASS,GRASS,GRASS,GRASS,GRASS,GRASS,GRASS,GRASS,GRASS,GRASS,GRASS,GRASS,GRASS,GRASS,GRASS,GRASS,GRASS,GRASS,GRASS,GRASS,GRASS,GRASS,GRASS,GRASS,GRASS,GRASS,GRASS,GRASS,GRASS,GRASS,GRASS,GRASS,GRASS,GRASS,GRASS,GRASS,GRASS,GRASS,GRASS,GRASS,GRASS,GRASS,GRASS,GRASS,GRASS,GRASS,GRASS,GRASS,GRASS,GRASS,GRASS,GRASS,GRASS,GRASS,GRASS,GRASS,GRASS,GRASS,GRASS,GRASS,GRASS,GRASS,GRASS
GRASS,GRASS,GRASS,WATER,GRASS,GRASS,GRASS,GRASS,GRASS,GRASS,GRASS,GRASS,GRASS,GRASS,GRASS,GRASS,GRASS,GRASS,GRASS,GRASS,GRASS,GRASS,GRASS,GRASS,GRASS,GRASS,GRASS,GRASS,GRASS,GRASS,GRASS,GRASS,GRASS,GRASS,GRASS,WATER,GRASS,GRASS,GRASS,GRASS,GRASS,GRASS,GRASS,GRASS,GRASS,GRASS,GRASS,GRASS,GRASS,GRASS,GRASS,GRASS,GRASS,GRASS,GRASS,GRASS,GRASS,GRASS,GRASS,GRASS,GRASS,GRASS,GRASS,GRASS
GRASS,GRASS,GRASS,GRASS,GRASS,GRASS,GRASS,GRASS,GRASS,GRASS,GRASS,GRASS,GRASS,GRASS,GRASS,GRASS,WATER,GRASS,GRASS,GRASS,GRASS,GRASS,GRASS,GRASS,GRASS,GRASS,GRASS,GRASS,GRASS,GRASS,GRASS,GRASS,GRASS,GRASS,GRASS,GRASS,GRASS,GRASS,GRASS,GRASS,GRASS,GRASS,GRASS,GRASS,GRASS,GRASS,GRASS,GRASS,WATER,GRASS,GRASS,GRASS,GRASS,GRASS,GRASS,GRASS,GRASS,GRASS,GRASS,GRASS,GRASS,GRASS,GRASS,GRASS
GRASS,GRASS,GRASS,GRASS,GRASS,GRASS,GRASS,GRASS,GRASS,GRASS,GRASS,GRASS,GRASS,GRASS,GRASS,GRASS,WATER,WATER,WATER,WATER,GRASS,GRASS,GRASS,GRASS,GRASS,WATER,GRASS,GRASS,GRASS,GRASS,GRASS,GRASS,GRASS,GRASS,GRASS,GRASS,GRASS,GRASS,GRASS,GRASS,GRASS,GRASS,GRASS,GRASS,GRASS,GRASS,GRASS,GRASS,WATER,WATER,WATER,WATER,GRASS,GRASS,GRASS,GRASS,GRASS,WATER,GRASS,GRASS,GRASS,GRASS,GRASS,GRASS
GRASS,GRASS,GRASS,GRASS,GRASS,GRASS,GRASS,WATER,GRASS,GRASS,GRASS,GRASS,GRASS,GRASS,GRASS,GRASS,GRASS,GRASS,GRASS,GRASS,GRASS,GRASS,GRASS,GRASS,WATER,WATER,GRASS,GRASS,GRASS,GRASS,GRASS,GRASS,GRASS,GRASS,GRASS,GRASS,GRASS,GRASS,GRASS,WATER,GRASS,GRASS,GRASS,GRASS,GRASS,GRASS,GRASS,GRASS,GRASS,GRASS,GRASS,GRASS,GRASS,GRASS,GRASS,GRASS,WATER,WATER,GRASS,GRASS,GRASS,GRASS,GRASS,GRASS
GRASS,GRASS,GRASS,GRASS,GRASS,GRASS,GRASS,GRASS,GRASS,GRASS,GRASS,GRASS,GRASS,GRASS,GRASS,GRASS,GRASS,GRASS,GRASS,GRASS,GRASS,GRASS,GRASS,GRASS,WATER,WATER,GRASS,GRASS,GRASS,GRASS,GRASS,GRASS,GRASS,GRASS,GRASS,GRASS,GRASS,GRASS,GRASS,GRASS,GRASS,GRASS,GRASS,GRASS,GRASS,GRASS,GRASS,GRASS,GRASS,GRASS,GRASS,GRASS,GRASS,GRASS,GRASS,GRASS,WATER,WATER,GRASS,GRASS,GRASS,GRASS,GRASS,GRASS
GRASS,GRASS,GRASS,GRASS,GRASS,GRASS,GRASS,GRASS,GRASS,GRASS,GRASS,GRASS,GRASS,GRASS,GRASS,GRASS,GRASS,GRASS,GRASS,GRASS,GRASS,GRASS,GRASS,GRASS,WATER,WATER,GRASS,GRASS,GRASS,GRASS,GRASS,GRASS,GRASS,GRASS,GRASS,GRASS,GRASS,GRASS,GRASS,GRASS,GRASS,GRASS,GRASS,GRASS,GRASS,GRASS,GRASS,GRASS,GRASS,GRASS,GRASS,GRASS,GRASS,GRASS,GRASS,GRASS,WATER,WATER,GRASS,GRASS,GRASS,GRASS,GRASS,GRASS
GRASS,GRASS,GRASS,GRASS,GRASS,GRASS,GRASS,GRASS,GRASS,GRASS,GRASS,GRASS,GRASS,GRASS,GRASS,WATER,GRASS,GRASS,GRASS,GRASS,GRASS,GRASS,GRASS,GRASS,WATER,WATER,GRASS,GRASS,GRASS,GRASS,GRASS,GRASS,GRASS,GRASS,GRASS,GRASS,GRASS,GRASS,GRASS,GRASS,GRASS,GRASS,GRASS,GRASS,GRASS,GRASS,GRASS,WATER,GRASS,GRASS,GRASS,GRASS,GRASS,GRASS,GRASS,GRASS,WATER,WATER,GRASS,GRASS,GRASS,GRASS,GRASS,GRASS
GRASS,GRASS,GRASS,GRASS,GRASS,GRASS,GRASS,GRASS,GRASS,GRASS,GRASS,GRASS,GRASS,GRASS,GRASS,GRASS,GRASS,GRASS,GRASS,GRASS,GRASS,GRASS,GRASS,GRASS,WATER,WATER,GRASS,GRASS,GRASS,GRASS,GRASS,GRASS,GRASS,GRASS,GRASS,GRASS,GRASS,GRASS,GRASS,GRASS,GRASS,GRASS,GRASS,GRASS,GRASS,GRASS,GRASS,GRASS,GRASS,GRASS,GRASS,GRASS,GRASS,GRASS,GRASS,GRASS,WATER,WATER,GRASS,GRASS,GRASS,GRASS,GRASS,GRASS
GRASS,GRASS,GRASS,GRASS,GRASS,GRASS,GRASS,GRASS,GRASS,GRASS,GRASS,GRASS,GRASS,GRASS,GRASS,GRASS,GRASS,GRASS,GRASS,GRASS,GRASS,GRASS,GRASS,GRASS,WATER,WATER,GRASS,GRASS,GRASS,GRASS,GRASS,GRASS,GRASS,GRASS,GRASS,GRASS,GRASS,GRASS,GRASS,GRASS,GRASS,GRASS,GRASS,GRASS,GRASS,GRASS,GRASS,GRASS,GRASS,GRASS,GRASS,GRASS,GRASS,GRASS,GRASS,GRASS,WATER,WATER,GRASS,GRASS,GRASS,GRASS,GRASS,GRASS
GRASS,GRASS,GRASS,GRASS,GRASS,GRASS,GRASS,GRASS,GRASS,WATER,GRASS,GRASS,GRASS,GRASS,GRASS,GRASS,GRASS,GRASS,GRASS,GRASS,GRASS,GRASS,WATER,GRASS,WATER,WATER,GRASS,WATER,GRASS,GRASS,GRASS,GRASS,GRASS,GRASS,GRASS,GRASS,GRASS,GRASS,GRASS,GRASS,GRASS,WATER,GRASS,GRASS,GRASS,GRASS,GRASS,GRASS,GRASS,GRASS,GRASS,GRASS,GRASS,GRASS,WATER,GRASS,WATER,WATER,GRASS,WATER,GRASS,GRASS,GRASS,GRASS
GRASS,GRASS,GRASS,GRASS,GRASS,GRASS,GRASS,GRASS,GRASS,GRASS,GRASS,GRASS,GRASS,GRASS,GRASS,GRASS,GRASS,GRASS,GRASS,GRASS,GRASS,WATER,WATER,WATER,WATER,WATER,WATER,WATER,WATER,GRASS,GRASS,GRASS,GRASS,GRASS,GRASS,GRASS,GRASS,GRASS,GRASS,GRASS,GRASS,GRASS,GRASS,GRASS,GRASS,GRASS,GRASS,GRASS,GRASS,GRASS,GRASS,GRASS,GRASS,WATER,WATER,WATER,WATER,WATER,WATER,WATER,WATER,GRASS,GRASS,GRASS
GRASS,GRASS,GRASS,GRASS,GRASS,GRASS,GRASS,GRASS,GRASS,GRASS,GRASS,GRASS,SPAWN,GRASS,GRASS,GRASS,GRASS,GRASS,GRASS,GRASS,GRASS,WATER,WATER,WATER,WATER,WATER,WATER,WATER,WATER,GRASS,GRASS,GRASS,GRASS,GRASS,GRASS,GRASS,GRASS,GRASS,GRASS,GRASS,GRASS,GRASS,GRASS,GRASS,GRASS,GRASS,GRASS,GRASS,GRASS,GRASS,GRASS,GRASS,GRASS,WATER,WATER,WATER,WATER,WATER,WATER,WATER,WATER,GRASS,GRASS,GRASS
GRASS,GRASS,GRASS,WATER,WATER,WATER,GRASS,GRASS,GRASS,GRASS,GRASS,GRASS,GRASS,GRASS,GRASS,GRASS,GRASS,GRASS,GRASS,GRASS,GRASS,GRASS,WATER,GRASS,GRASS,GRASS,GRASS,WATER,GRASS,GRASS,GRASS,GRASS,GRASS,GRASS,GRASS,WATER,WATER,WATER,GRASS,GRASS,GRASS,GRASS,GRASS,GRASS,GRASS,GRASS,GRASS,GRASS,GRASS,GRASS,GRASS,GRASS,GRASS,GRASS,WATER,GRASS,GRASS,GRASS,GRASS,WATER,GRASS,GRASS,GRASS,GRASS
GRASS,GRASS,GRASS,WATER,WATER,WATER,GRASS,GRASS,GRASS,GRASS,GRASS,GRASS,GRASS,GRASS,GRASS,WATER,GRASS,GRASS,GRASS,WATER,GRASS,GRASS,GRASS,GRASS,GRASS,GRASS,GRASS,GRASS,GRASS,GRASS,GRASS,GRASS,GRASS,GRASS,GRASS,WATER,WATER,WATER,GRASS,GRASS,GRASS,GRASS,GRASS,GRASS,GRASS,GRASS,GRASS,WATER,GRASS,GRASS,GRASS,WATER,GRASS,GRASS,GRASS,GRASS,GRASS,GRASS,GRASS,GRASS,GRASS,GRASS,GRASS,GRASS
GRASS,GRASS,GRASS,WATER,WATER,WATER,GRASS,GRASS,GRASS,GRASS,GRASS,GRASS,GRASS,GRASS,WATER,GRASS,GRASS,GRASS,GRASS,GRASS,GRASS,GRASS,GRASS,GRASS,GRASS,GRASS,GRASS,GRASS,GRASS,GRASS,GRASS,GRASS,GRASS,GRASS,GRASS,WATER,WATER,WATER,GRASS,GRASS,GRASS,GRASS,GRASS,GRASS,GRASS,GRASS,WATER,GRASS,GRASS,GRASS,GRASS,GRASS,GRASS,GRASS,GRASS,GRASS,GRASS,GRASS,GRASS,GRASS,GRASS,GRASS,GRASS,GRASS
GRASS,GRASS,GRASS,GRASS,GRASS,GRASS,GRASS,GRASS,GRASS,GRASS,GRASS,GRASS,GRASS,WATER,GRASS,GRASS,GRASS,GRASS,GRASS,GRASS,GRASS,GRASS,GRASS,GRASS,GRASS,GRASS,GRASS,GRASS,GRASS,GRASS,GRASS,GRASS,GRASS,GRASS,GRASS,GRASS,GRASS,GRASS,GRASS,GRASS,GRASS,GRASS,GRASS,GRASS,GRASS,WATER,GRASS,GRASS,GRASS,GRASS,GRASS,GRASS,GRASS,GRASS,GRASS,GRASS,GRASS,GRASS,GRASS,GRASS,GRASS,GRASS,GRASS,GRASS
GRASS,GRASS,GRASS,GRASS,GRASS,GRASS,GRASS,GRASS,GRASS,GRASS,GRASS,GRASS,GRASS,GRASS,GRASS,GRASS,GRASS,GRASS,GRASS,GRASS,GRASS,GRASS,GRASS,GRASS,GRASS,GRASS,GRASS,GRASS,GRASS,GRASS,GRASS,GRASS,GRASS,GRASS,GRASS,GRASS,GRASS,GRASS,GRASS,GRASS,GRASS,GRASS,GRASS,GRASS,GRASS,GRASS,GRASS,GRASS,GRASS,GRASS,GRASS,GRASS,GRASS,GRASS,GRASS,GRASS,GRASS,GRASS,GRASS,GRASS,GRASS,GRASS,GRASS,GRASS
GRASS,GRASS,GRASS,GRASS,GRASS,GRASS,GRASS,GRASS,GRASS,GRASS,GRASS,GRASS,GRASS,GRASS,GRASS,GRASS,GRASS,GRASS,GRASS,GRASS,GRASS,GRASS,GRASS,GRASS,GRASS,GRASS,GRASS,GRASS,GRASS,GRASS,GRASS,GRASS,GRASS,GRASS,GRASS,GRASS,GRASS,GRASS,GRASS,GRASS,GRASS,GRASS,GRASS,GRASS,GRASS,GRASS,GRASS,GRASS,GRASS,GRASS,GRASS,GRASS,GRASS,GRASS,GRASS,GRASS,GRASS,GRASS,GRASS,GRASS,GRASS,GRASS,GRASS,GRASS
GRASS,GRASS,GRASS,WATER,GRASS,GRASS,GRASS,GRASS,GRASS,GRASS,GRASS,GRASS,GRASS,GRASS,GRASS,GRASS,GRASS,GRASS,GRASS,GRASS,GRASS,GRASS,GRASS,GRASS,GRASS,GRASS,GRASS,GRASS,GRASS,GRASS,GRASS,GRASS,GRASS,GRASS,GRASS,WATER,GRASS,GRASS,GRASS,GRASS,GRASS,GRASS,GRASS,GRASS,GRASS,GRASS,GRASS,GRASS,GRASS,GRASS,GRASS,GRASS,GRASS,GRASS,GRASS,GRASS,GRASS,GRASS,GRASS,GRASS,GRASS,GRASS,GRASS,GRASS
GRASS,GRASS,GRASS,GRASS,GRASS,GRASS,GRASS,GRASS,GRASS,GRASS,GRASS,GRASS,GRASS,GRASS,GRASS,GRASS,WATER,GRASS,GRASS,GRASS,GRASS,GRASS,GRASS,GRASS,GRASS,GRASS,GRASS,GRASS,GRASS,GRASS,GRASS,GRASS,GRASS,GRASS,GRASS,GRASS,GRASS,GRASS,GRASS,GRASS,GRASS,GRASS,GRASS,GRASS,GRASS,GRASS,GRASS,GRASS,WATER,GRASS,GRASS,GRASS,GRASS,GRASS,GRASS,GRASS,GRASS,GRASS,GRASS,GRASS,GRASS,GRASS,GRASS,GRASS
GRASS,GRASS,GRASS,GRASS,GRASS,GRASS,GRASS,GRASS,GRASS,GRASS,GRASS,GRASS,GRASS,GRASS,GRASS,GRASS,WATER,WATER,WATER,WATER,GRASS,GRASS,GRASS,GRASS,GRASS,WATER,GRASS,GRASS,GRASS,GRASS,GRASS,GRASS,GRASS,GRASS,GRASS,GRASS,GRASS,GRASS,GRASS,GRASS,GRASS,GRASS,GRASS,GRASS,GRASS,GRASS,GRASS,GRASS,WATER,WATER,WATER,WATER,GRASS,GRASS,GRASS,GRASS,GRASS,WATER,GRASS,GRASS,GRASS,GRASS,GRASS,GRASS
GRASS,GRASS,GRASS,GRASS,GRASS,GRASS,GRASS,WATER,GRASS,GRASS,GRASS,GRASS,GRASS,GRASS,GRASS,GRASS,GRASS,GRASS,GRASS,GRASS,GRASS,GRASS,GRASS,GRASS,WATER,WATER,GRASS,GRASS,GRASS,GRASS,GRASS,GRASS,GRASS,GRASS,GRASS,GRASS,GRASS,GRASS,GRASS,WATER,GRASS,GRASS,GRASS,GRASS,GRASS,GRASS,GRASS,GRASS,GRASS,GRASS,GRASS,GRASS,GRASS,GRASS,GRASS,GRASS,WATER,WATER,GRASS,GRASS,GRASS,GRASS,GRASS,GRASS
GRASS,GRASS,GRASS,GRASS,GRASS,GRASS,GRASS,GRASS,GRASS,GRASS,GRASS,GRASS,GRASS,GRASS,GRASS,GRASS,GRASS,GRASS,GRASS,GRASS,GRASS,GRASS,GRASS,GRASS,WATER,WATER,GRASS,GRASS,GRASS,GRASS,GRASS,GRASS,GRASS,GRASS,GRASS,GRASS,GRASS,GRASS,GRASS,GRASS,GRASS,GRASS,GRASS,GRASS,GRASS,GRASS,GRASS,GRASS,GRASS,GRASS,GRASS,GRASS,GRASS,GRASS,GRASS,GRASS,WATER,WATER,GRASS,GRASS,GRASS,GRASS,GRASS,GRASS
GRASS,GRASS,GRASS,GRASS,GRASS,GRASS,GRASS,GRASS,GRASS,GRASS,GRASS,GRASS,GRASS,GRASS,GRASS,GRASS,GRASS,GRASS,GRASS,GRASS,GRASS,GRASS,GRASS,GRASS,WATER,WATER,GRASS,GRASS,GRASS,GRASS,GRASS,GRASS,GRASS,GRASS,GRASS,GRASS,GRASS,GRASS,GRASS,GRASS,GRASS,GRASS,GRASS,GRASS,GRASS,GRASS,GRASS,GRASS,GRASS,GRASS,GRASS,GRASS,GRASS,GRASS,GRASS,GRASS,WATER,WATER,GRASS,GRASS,GRASS,GRASS,GRASS,GRASS
GRASS,GRASS,GRASS,GRASS,GRASS,GRASS,GRASS,GRASS,GRASS,GRASS,GRASS,GRASS,GRASS,GRASS,GRASS,WATER,GRASS,GRASS,GRASS,GRASS,GRASS,GRASS,GRASS,GRASS,WATER,WATER,GRASS,GRASS,GRASS,GRASS,GRASS,GRASS,GRASS,GRASS,GRASS,GRASS,GRASS,GRASS,GRASS,GRASS,GRASS,GRASS,GRASS,GRASS,GRASS,GRASS,GRASS,WATER,GRASS,GRASS,GRASS,GRASS,GRASS,GRASS,GRASS,GRASS,WATER,WATER,GRASS,GRASS,GRASS,GRASS,GRASS,GRASS
GRASS,GRASS,GRASS,GRASS,GRASS,GRASS,GRASS,GRASS,GRASS,GRASS,GRASS,GRASS,GRASS,GRASS,GRASS,GRASS,GRASS,GRASS,GRASS,GRASS,GRASS,GRASS,GRASS,GRASS,WATER,WATER,GRASS,GRASS,GRASS,GRASS,GRASS,GRASS,GRASS,GRASS,GRASS,GRASS,GRASS,GRASS,GRASS,GRASS,GRASS,GRASS,GRASS,GRASS,GRASS,GRASS,GRASS,GRASS,GRASS,GRASS,GRASS,GRASS,GRASS,GRASS,GRASS,GRASS,WATER,WATER,GRASS,GRASS,GRASS,GRASS,GRASS,GRASS
GRASS,GRASS,GRASS,GRASS,GRASS,GRASS,GRASS,GRASS,GRASS,GRASS,GRASS,GRASS,GRASS,GRASS,GRASS,GRASS,GRASS,GRASS,GRASS,GRASS,GRASS,GRASS,GRASS,GRASS,WATER,WATER,GRASS,GRASS,GRASS,GRASS,GRASS,GRASS,GRASS,GRASS,GRASS,GRASS,GRASS,GRASS,GRASS,GRASS,GRASS,GRASS,GRASS,GRASS,GRASS,GRASS,GRASS,GRASS,GRASS,GRASS,GRASS,GRASS,GRASS,GRASS,GRASS,GRASS,WATER,WATER,GRASS,GRASS,GRASS,GRASS,GRASS,GRASS
GRASS,GRASS,GRASS,GRASS,GRASS,GRASS,GRASS,GRASS,GRASS,WATER,GRASS,GRASS,GRASS,GRASS,GRASS,GRASS,GRASS,GRASS,GRASS,GRASS,GRASS,GRASS,WATER,GRASS,WATER,WATER,GRASS,WATER,GRASS,GRASS,GRASS,GRASS,GRASS,GRASS,GRASS,GRASS,GRASS,GRASS,GRASS,GRASS,GRASS,WATER,GRASS,GRASS,GRASS,GRASS,GRASS,GRASS,GRASS,GRASS,GRASS,GRASS,GRASS,GRASS,WATER,GRASS,WATER,WATER,GRASS,WATER,GRASS,GRASS,GRASS,GRASS
GRASS,GRASS,GRASS,GRASS,GRASS,GRASS,GRASS,GRASS,GRASS,GRASS,GRASS,GRASS,GRASS,GRASS,GRASS,GRASS,GRASS,GRASS,GRASS,GRASS,GRASS,WATER,WATER,WATER,WATER,WATER,WATER,WATER,WATER,GRASS,GRASS,GRASS,GRASS,GRASS,GRASS,GRASS,GRASS,GRASS,GRASS,GRASS,GRASS,GRASS,GRASS,GRASS,GRASS,GRASS,GRASS,GRASS,GRASS,GRASS,GRASS,GRASS,GRASS,WATER,WATER,WATER,WATER,WATER,WATER,WATER,WATER,GRASS,GRASS,GRASS
GRASS,GRASS,GRASS,GRASS,GRASS,GRASS,GRASS,GRASS,GRASS,GRASS,GRASS,GRASS,GRASS,GRASS,GRASS,GRASS,GRASS,GRASS,GRASS,GRASS,GRASS,WATER,WATER,WATER,WATER,WATER,WATER,WATER,WATER,GRASS,GRASS,GRASS,GRASS,GRASS,GRASS,GRASS,GRASS,GRASS,GRASS,GRASS,GRASS,GRASS,GRASS,GRASS,GRASS,GRASS,GRASS,GRASS,GRASS,GRASS,GRASS,GRASS,GRASS,WATER,WATER,WATER,WATER,WATER,WATER,WATER,WATER,GRASS,GRASS,GRASS
GRASS,GRASS,GRASS,WATER,WATER,WATER,GRASS,GRASS,GRASS,GRASS,GRASS,GRASS,GRASS,GRASS,GRASS,GRASS,GRASS,GRASS,GRASS,GRASS,GRASS,GRASS,WATER,GRASS,GRASS,GRASS,GRASS,WATER,GRASS,GRASS,GRASS,GRASS,GRASS,GRASS,GRASS,WATER,WATER,WATER,GRASS,GRASS,GRASS,GRASS,GRASS,GRASS,GRASS,GRASS,GRASS,GRASS,GRASS,GRASS,GRASS,GRASS,GRASS,GRASS,WATER,GRASS,GRASS,GRASS,GRASS,WATER,GRASS,GRASS,GRASS,GRASS
GRASS,GRASS,GRASS,WATER,WATER,WATER,GRASS,GRASS,GRASS,GRASS,GRASS,GRASS,GRASS,GRASS,GRASS,WATER,GRASS,GRASS,GRASS,WATER,GRASS,GRASS,GRASS,GRASS,GRASS,GRASS,GRASS,GRASS,GRASS,GRASS,GRASS,GRASS,GRASS,GRASS,GRASS,WATER,WATER,WATER,GRASS,GRASS,GRASS,GRASS,GRASS,GRASS,GRASS,GRASS,GRASS,WATER,GRASS,GRASS,GRASS,WATER,GRASS,GRASS,GRASS,GRASS,GRASS,GRASS,GRASS,GRASS,GRASS,GRASS,GRASS,GRASS
GRASS,GRASS,GRASS,WATER,WATER,WATER,GRASS,GRASS,GRASS,GRASS,GRASS,GRASS,GRASS,GRASS,WATER,GRASS,GRASS,GRASS,GRASS,GRASS,GRASS,GRASS,GRASS,GRASS,GRASS,GRASS,GRASS,GRASS,GRASS,GRASS,GRASS,GRASS,GRASS,GRASS,GRASS,WATER,WATER,WATER,GRASS,GRASS,GRASS,GRASS,GRASS,GRASS,GRASS,GRASS,WATER,GRASS,GRASS,GRASS,GRASS,GRASS,GRASS,GRASS,GRASS,GRASS,GRASS,GRASS,GRASS,GRASS,GRASS,GRASS,GRASS,GRASS
GRASS,GRASS,GRASS,GRASS,GRASS,GRASS,GRASS,GRASS,GRASS,GRASS,GRASS,GRASS,GRASS,WATER,GRASS,GRASS,GRASS,GRASS,GRASS,GRASS,GRASS,GRASS,GRASS,GRASS,GRASS,GRASS,GRASS,GRASS,GRASS,GRASS,GRASS,GRASS,GRASS,GRASS,GRASS,GRASS,GRASS,GRASS,GRASS,GRASS,GRASS,GRASS,GRASS,GRASS,GRASS,WATER,GRASS,GRASS,GRASS,GRASS,GRASS,GRASS,GRASS,GRASS,GRASS,GRASS,GRASS,GRASS,GRASS,GRASS,GRASS,GRASS,GRASS,GRASS
GRASS,GRASS,GRASS,GRASS,GRASS,GRASS,GRASS,GRASS,GRASS,GRASS,GRASS,GRASS,GRASS,GRASS,GRASS,GRASS,GRASS,GRASS,GRASS,GRASS,GRASS,GRASS,GRASS,GRASS,GRASS,GRASS,GRASS,GRASS,GRASS,GRASS,GRASS,GRASS,GRASS,GRASS,GRASS,GRASS,GRASS,GRASS,GRASS,GRASS,GRASS,GRASS,GRASS,GRASS,GRASS,GRASS,GRASS,GRASS,GRASS,GRASS,GRASS,GRASS,GRASS,GRASS,GRASS,GRASS,GRASS,GRASS,GRASS,GRASS,GRASS,GRASS,GRASS,GRASS
